XXXXXXXXXXXXXXXXXXXXXXXXXXXXXXXXXXXXXXXXXXXXXXXXX
P           X             X     X   X           X
X XXXXXXX X X XXXXXXXXXXX XXX X X XXX XXX XXXXXXX
X   X   X X   X         X     X X   X   X       X
XXX X X X XXX X XXXXXXX X XXXXX XXX XXX XXXXXXX X
X X   X X   X X X     X X X   X     X   X   X   X
X X XXXXXXX XXX XXX X X X X X X XXXXX XXX X X XXX
X   X     X X   X   X X X X X X X     X X X   X X
X XXX XXX X X XXX XXX X XXX X XXX XXXXX X X XXX X
X X X X X X X     X X X     X     X     X X X X X
X X X X X X XXXXXXX X XXXXXXXXXXXXXXX XXX XXX X X
X X X X X X X       X X     X       X   X     X X
X X X X X X X XXXXX X X XXX X XXXXX X X XXXXXXX X
X   X X   X X     X   X   X   X     X X         X
XXX X XXX X XXXXX XXXXX X XXXXX XXXXXXX X XXXXX X
X   X   X       X X     X X     X     X X X   X X
X XXXXX XXXXXXX X XXXXXXX X XXXXXXX X XXX XXX X X
X X   X   X   X X       X X         X X   X   X X
X XXX XXX X XXX XXXXXXX X XXXXXXXXXXX X XXX XXX X
X   X   X X X   X   X   X X         X X   X   X X
XXX X XXX X X XXX X X XXX XXX XXXXXXX X X X X X X
X     X   X   X   X X   X   X   X     X X X X   X
X XXXXX XXXXX X XXX XXX X X X X X XXXXX X X XXXXX
X X   X X   X X X X X X X X X X   X     X X   X X
XXX X X X X X X X X X X XXX XXXXX X XXXXX XXX X X
X   X   X X X   X     X   X     X X X     X   X X
X XXXXX X X XXXXX XXXXXXX XXXXX X XXX XXXXX XXX X
X X     X X X       X   X X   X X     X   X X   X
X XXXXXXX X X XXXXXXX X X X X X XXXXXXX X X X XXX
X     X   X X   X     X X X X X X       X X X   X
X XXX X XXX XXX X XXXXX X X X X XXX XXXXX X XXX X
X X X   X   X X X     X X   X X   X X   X X   X X
X X XXXXX XXX X XXX XXX XXXXX XXX X X X X XXX X X
X X   X X X     X   X       X     X X X X X   X X
X X X X X XXXXXXX XXX XXXXXXXXXXXXX X X X X XXX X
X   X   X X     X   X         X       X X X X   X
XXXXXXX X X XXX XXX XXXXXXXXX X XXXXXXXXX X X X X
X       X   X X   X     X   X   X   X     X   X X
X XXXXXXXXXXX XXX XXXXX XXX XXXXXXX X XXXXXXXXX X
X   X         X       X X   X       X X     X   X
XXX X XXX X XXX XXXXX X X XXX XXX XXX X XXX X XXX
X X X   X X X   X   X X X X   X   X   X   X X   X
X X X XXX X X XXX X X X X X XXX XXX X XXX X XXX X
X X X X   X X X   X   X X   X   X   X X   X     X
X X XXX XXX X XXXXXXXXX X XXX XXX XXXXX XXXXXXXXX
X X   X X X X       X   X   X X   X   X X       X
X XXX X X X XXXXXXX X XXXXXXX X XXX X X XXX XXX X
X       X         X           X     X       X   K
XXXXXXXXXXXXXXXXXXXXXXXXXXXXXXXXXXXXXXXXXXXXXXXXX
